1 1 1 1 1 1 1 1 1 1 1 1 1 1
1 0 1 1 6 0 0 0 0 1 1 0 0 1
1 0 1 0 0 0 0 0 5 0 1 0 0 1
1 9 0 0 0 0 0 0 0 0 1 0 0 1
1 0 0 4 0 0 2 0 0 0 0 0 7 1
1 7 9 1 3 0 1 1 1 0 0 0 0 1
1 1 1 1 1 1 1 1 1 1 1 1 1 1